7
12
50
HHHHHHHHHHHHHHHHHHHHHHHHHHHHHHHHHHHHHHHHHHHHHHHHHH
HCCCC    XXX       RRR    CCCXX  W    CCCCCCCC   H
H SCCXX  DCC   XXC RRRXXXCCCCCX  W   D    R XXXX H
H CCC    XXX CCCCCCXXXXXXXXX     W  CCC   D      H
HXXXX    CCC X      W            W XXXXXXXXXXX   H
HCCCCC    XXXXCC   CCC        WWWW CCCCCCCCCCC   H
HXXXXX        CCC                W    D     D    H
HCCCCXXXCCCCCCC XXXXC     C      W               H
H  XXXXXXX       C  CCCCCCC     WW  XXXXXXXXXX   H
H CCCCCCCCC             XXXXXXCCCCCCCCCCCCCCCCCC H
H    W     XXXXXXXXXXXXX X   XXXXXXXXXX  DD    E H
HHHHHHHHHHHHHHHHHHHHHHHHHHHHHHHHHHHHHHHHHHHHHHHHHH

