7
12
50
HHHHHHHHHHHHHHHHHHHHHHHHHHHHHHHHHHHHHHHHHHHHHHHHHH
H--------R---------RRR-----------W---------------H
H----S---D---------RRR-----------W---D----R------H
H--------------------------------W--------D------H
H-------------------W------------W---------------H
H---------DDDD----------------WWWW---------------H
H--------------------------------W----D-----D----H
HWW------------------------------W---------------H
H-------------------------------WW---------------H
H------------------------------------------------H
H----W-----------------------------------DD----E-H
HHHHHHHHHHHHHHHHHHHHHHHHHHHHHHHHHHHHHHHHHHHHHHHHHH

